1111111111100000000000000000000000000000
1000000000100000000000000000000000000000
1000000000100111111111111111000001111110
1000000000100111111111111111000001111110
1000000000100111111111111111000001111110
1000000000100111111111111111000001111110
1000000000100111111111111111000001111110
1000000000100111111111111111000000000000
1000000000100111111111111111000000000000
1000000000100111111111111111000001111110
1111111111100000000000000000000001111110
0000000000000000000000000000000001111110
1011110000000000000000000000000001111110
1011110000000011111000111110000001111110
1011110000000011111000111110000000000000
1011110000000011111000111110000000000000
1011110000000011111000111110000001111110
1011110000000011111000111110000001111110
1000000000000011111000111110000001111110
1011110000000000000000000000000001111110
1011110000000000000000000000000001111110
1011110000000000000000000000000000000000
1011110000000000000000000000000000000000
1011110000000011111000111110000001111110
1011110000000011111000111110000001111110
1000000000000011111000111110000001111110
1011110000000011111000111110000001111110
1011110000000011111000111110000001111110
1011110000000011111000111110000000000000
1011110000000000000000000000000001111110
1011110000000000000000000000000001111110
1011110000000000000000000000000001111110
1000000000000111111111111111000001111110
1011110000000111111111111111000001111110
1011110000000111111111111111000000000000
1011110000000111111111111111000001111110
1011110000000111111111111111000001111110
1011110000000111111111111111000001111110
1011110000000111111111111111000001111110
1000000000000000000000000000000001111110
